chatgpt-web-6vek.onrender.com	onrender.com	chat#gpt#	Chat
chat.abcgpt.net	abcgpt.net	chat#gpt#	Chat
chat-hk.openai-sb.com	openai-sb.com	ai#chat#	Chat
chatbot.chatgptworld.net	chatgptworld.net	hatbot#chat#gpt#	Chat
chatgpt.aicrpop.top	aicrpop.top	ai#chat#gpt#	Chat
chatgpt-fangtang.top	chatgpt-fangtang.top	chat#gpt#	Chat
www.hzffchatgpt.asia	hzffchatgpt.asia	chat#gpt#	Chat
getchatgptright.com	getchatgptright.com	chat#gpt#	Chat
chatgpttrainings.getlearnworlds.com	getlearnworlds.com	chat#gpt#	Chat
outer-ai-chatbot-agent-hz-online.netease.com	netease.com	hatbot#ai#	Chat
chatgpt-code-interpreter-guide.onrender.com.donobuy.com	donobuy.com	chat#gpt#	博彩
openainew.bdtm2com.com	bdtm2com.com	open#ai#	博彩
aiqeoi.cloudeeee.com	cloudeeee.com	ai#cloude#	博彩
7ai2.xnmcjgpt.com	xnmcjgpt.com	ai#gpt#	博彩
chatgpt754468.lovecodesbook.com	lovecodesbook.com	chat#gpt#	博彩
chatgpt923.zhongbo-rail-fastening.com	zhongbo-rail-fastening.com	chat#gpt#	博彩
m.chatgpt138.com	chatgpt138.com	chat#gpt#	博彩
chatgpt561.elustro.net	elustro.net	chat#gpt#	博彩
chat.aiwemedia.com	aiwemedia.com	ai#chat#	博彩
www.qaopenai.iwencai.com	iwencai.com	open#ai#	博彩
gpt8.aiwencai.cn	aiwencai.cn	ai#gpt#	博彩
claude.aiwencai.com.cn	aiwencai.com.cn	claude#ai#	博彩
worldchatcenter.aiwencai.com	aiwencai.com	ai#chat#	博彩
claude.m.aiwencai.net	aiwencai.net	claude#ai#	博彩
chatgpt8212651.yfrjia.com	yfrjia.com	chat#gpt#	博彩
openainew.weileeasy.com	weileeasy.com	open#ai#	博彩
openai.189hd.com	189hd.com	open#ai#	博彩
xingaichaopengmianfei.ggfwx.com	ggfwx.com	open#ai#	博彩
qqgptnt.aiproject.top	aiproject.top	ai#gpt#	博彩
chat.infobizai.com	infobizai.com	ai#chat#	博彩
chatgpt35652.gongzheng148.com	gongzheng148.com	chat#gpt#	博彩
chatai.jxcxjw.com	jxcxjw.com	ai#chat#	博彩
chatgpt-code-interpreter-guide.onrender.com.xajunbiao.com.cn	xajunbiao.com.cn	chat#gpt#	博彩
chatgpt896918.ys-chjy.com	ys-chjy.com	chat#gpt#	博彩
akbaai.chat-lovee.com	chat-lovee.com	ai#chat#	博彩
chatgpt-code-interpreter-guide.onrender.com.klshouyin.com	klshouyin.com	chat#gpt#	博彩
chatgpt-code-interpreter-guide.onrender.com.zgguolvqicai.com	zgguolvqicai.com	chat#gpt#	博彩
chatgpt-code-interpreter-guide.onrender.com.ceoffp.com	ceoffp.com	chat#gpt#	博彩
chatgpt-code-interpreter-guide.onrender.com.shanghaiduanrui.com	shanghaiduanrui.com	chat#gpt#	博彩
www.chatgptprovider.com	chatgptprovider.com	chat#gpt#	空
chat.ai-talk.live	ai-talk.live	ai#chat#	空
celebritychatai.com	celebritychatai.com	ai#chat#	空
learnopenai.info	learnopenai.info	open#ai#	空
www.chatboxai.com	chatboxai.com	ai#chat#	空
candyusa.we-openai.com	we-openai.com	open#ai#	空
www.im.ai-gpt.club	ai-gpt.club	ai#gpt#	空
chatgpt45.duaenterprises.net	duaenterprises.net	chat#gpt#	空
dangshixuexi.chat.chabotc.nl	chabotc.nl	chat#chabot#	空
www-gptgpotcio-com.xunfne.com	xunfne.com	gpot#gpt#	空
cgptj.aihunyan.com	aihunyan.com	ai#gpt#	空
467a-chat.gptdos.com	gptdos.com	chat#gpt#	空
openaitopic.surveytopic.com	surveytopic.com	open#ai#	空
chatgpthub.tech	chatgpthub.tech	chat#gpt#	空
5fqvf.chatgpt00000.com	chatgpt00000.com	chat#gpt#	空
homeofopenai.net	homeofopenai.net	open#ai#	其他-ai
chatgpt.who365.club	who365.club	chat#gpt#	其他-ai
antichatgpt.com	antichatgpt.com	chat#gpt#	其他-ai
beschatbot.ai	beschatbot.ai	hatbot#ai#	其他-ai
sucx-chatgpt.netlify.app	netlify.app	chat#gpt#	其他-ai
www.chatgpt-gratis.net	chatgpt-gratis.net	chat#gpt#	其他-ai
www.chatgptsuomi.com	chatgptsuomi.com	chat#gpt#	其他-ai
chelsea-openchat.com	chelsea-openchat.com	open#chat#	其他-ai
gpt-4-chat-ui.davidhao2.repl.co	davidhao2.repl.co	chat#gpt#	其他-ai
chatgptincomeacademy.com	chatgptincomeacademy.com	chat#gpt#	其他-ai
openai.cdy100.com	cdy100.com	open#ai#	其他-ai
chatgpt4dev.org	chatgpt4dev.org	chat#gpt#	其他-ai
www.openai.degree	openai.degree	open#ai#	其他-ai
mail.opendataai.com	opendataai.com	open#ai#	其他-ai
chatgptpowerai.com	chatgptpowerai.com	ai#chat#gpt#	其他-ai
chatgpt.whiter.online	whiter.online	chat#gpt#	其他-ai，比较神奇
www.chatgpt-edu.sjl.ztl.mybluehost.me	mybluehost.me	chat#gpt#	其他-ai，博客
chatgptnews.blog	chatgptnews.blog	chat#gpt#	其他-ai，博客
www.chatgpt.com.bz	chatgpt.com.bz	chat#gpt#	其他-ai，博客
chatgptvshuman.com	chatgptvshuman.com	chat#gpt#	其他-ai，博客
chatgptofuturo.com.br	chatgptofuturo.com.br	chat#gpt#	其他-ai，卖课
buy.bchatgpt.top	bchatgpt.top	chat#gpt#	其他-ai，卖账户
www.chatwithai.fun	chatwithai.fun	ai#chat#	其他-ai，自建
api.aiforopen.com	aiforopen.com	open#ai#	其他-cloudfare防护措施
www.capschat.ai	capschat.ai	ai#chat#	其他-js脚本与app
chatgpt.brookk.cloud	brookk.cloud	chat#gpt#	其他-博客
www.findopenai.com	findopenai.com	open#ai#	其他-博客
chatgptscenarios.com	chatgptscenarios.com	chat#gpt#	其他-博客
chatgpt-admin.cn	chatgpt-admin.cn	chat#gpt#	其他-博客
menterpriseopenaiarticlew23344.mdkblog.com	mdkblog.com	open#ai#	其他-博客
hire-chatgpt-developer92468.tinyblogging.com	tinyblogging.com	chat#gpt#	其他-博客
new.testchatgpt.xyz	testchatgpt.xyz	chat#gpt#	其他-测试网站
ailabs-chatbot.jiazheng.cloud	jiazheng.cloud	hatbot#ai#	其他-测试网站
www.openai.ngo	openai.ngo	open#ai#	其他-测试网站
m.openai.mly.app	mly.app	open#ai#	其他-测试网站
api.socialcopilot.ai	socialcopilot.ai	ai#copilot#	其他-测试网站
1chat.piaoliangai.com	piaoliangai.com	ai#chat#	其他-测试网站
chatwww.yuanyu.ai	yuanyu.ai	ai#chat#	其他-测试网站
openai.nop.cc	nop.cc	open#ai#	其他-测试网站
openai-api.aihelpme.vip	aihelpme.vip	open#ai#	其他-测试网站
app2.homechatgpt.one	homechatgpt.one	chat#gpt#	其他-测试网站
lijiejietest.wwwchat.zhongaiyuan.com	zhongaiyuan.com	ai#chat#	其他-测试网站
chat.bizai.live	bizai.live	ai#chat#	其他-测试网站
wmasechatgptmgr.koi.youkia.net	youkia.net	chat#gpt#	其他-测试网站
4444ai.events.service.ycgpt.com	ycgpt.com	ai#gpt#	其他-测试网站
openai-cn.cc	openai-cn.cc	open#ai#	其他-测试网站
livechat.fpt.ai	fpt.ai	ai#chat#	其他-测试网站
gptpyegpotlxdshbwhxp.ratnamresidence.com	ratnamresidence.com	gpot#gpt#	其他-测试网站
chatgpt.sunshinenny.top	sunshinenny.top	chat#gpt#	其他-测试网站
autoconfig.chat.nebula-ai.com	nebula-ai.com	ai#chat#	其他-测试网站
www.chatgpt.ninvfeng.xyz	ninvfeng.xyz	chat#gpt#	其他-测试网站
testai.awesomechat.cn	awesomechat.cn	ai#chat#	其他-测试网站
sbox-www.phpopenchat.nutaku.com	nutaku.com	chat#open#	其他-测试网站
openaipro.keepwork.com	keepwork.com	open#ai#	其他-测试网站
chatopen.top	chatopen.top	open#chat#	其他-测试网站
chatgpt.tycoding.cn	tycoding.cn	chat#gpt#	其他-测试网站
openai.zjf.plus	zjf.plus	open#ai#	其他-测试网站
chatai.api.how2d.com	how2d.com	ai#chat#	其他-测试网站
www.chatgpt.hkcdn.turuio.com	turuio.com	chat#gpt#	其他-测试网站
wss.chatgpt.lhtl.vip	lhtl.vip	chat#gpt#	其他-测试网站，故意写404
chat.aiwriter.vip	aiwriter.vip	ai#chat#	其他-测试网站，故意写404
gpt.aicat.ink	aicat.ink	ai#gpt#	其他-错误页面
zhenzhuyannaihuopentuliao.h-q.cn	h-q.cn	open#ai#	其他-错误页面
www.chatgpt818.site	chatgpt818.site	chat#gpt#	其他-错误页面
gptchatbotter.com	gptchatbotter.com	hatbot#gpt#	其他-错误页面
dev2-chatbot.agentz.ai	agentz.ai	hatbot#ai#	其他-错误页面
www.satriachatgpt.eu.org	satriachatgpt.eu.org	chat#gpt#	其他-错误页面
chatbot-ers-com.cbx.ai	cbx.ai	hatbot#ai#	其他-登录
chatai-tan-test.cloudforce.com	cloudforce.com	ai#chat#	其他-登录
chat18jjnk12s-prd8jjn.characterai.dev	characterai.dev	chat#ai#	其他-登录
whatsapp-chatd-msgr-edge-shv-4-sin6-aai-int1.dev.atg.se	atg.se	chat#ai#	其他-登录
www.snwjchatgpt.tech	snwjchatgpt.tech	chat#gpt#	其他-电影
openainew.baohushebei.com	baohushebei.com	open#ai#	其他-电子书
mabriley.extendchatgpt.com	extendchatgpt.com	chat#gpt#	其他-恶意推广
openai-75050.hou.com	hou.com	open#ai#	其他-个人网站
smachatgptera.eventbrite.com	eventbrite.com	chat#gpt#	其他-公司
www.chat-gpt-formation-e-commerce.com	chat-gpt-formation-e-commerce.com	chat#gpt#	其他-公司
opentok-textchat.recko.io	recko.io	chat#open#	其他-公司
aicapilot.org	aicapilot.org	ai#capilot#	其他-航空（不相关）
chatopenid.yellowpages.ca	yellowpages.ca	chat#open#	其他-黄页
hilkofpgpotcvqt.tech.aixuexi.com	aixuexi.com	ai#gpot#	其他-教育
bcloudec.yiaitao.net.cn	yiaitao.net.cn	ai#cloude#	其他-客服
aiopenscale-oceania-internal-alpha.foxycart.com	foxycart.com	open#ai#	其他-旅游商品
chatgpt.test.upcdn.net	upcdn.net	chat#gpt#	其他-卖CDN
chatgpt3ai.netlify.app	netlify.app	ai#chat#gpt#	其他-卖东西
www.chatgptfl.com	chatgptfl.com	chat#gpt#	其他-卖域名
openaizone.net	openaizone.net	open#ai#	其他-卖域名
openaimarkets.com	openaimarkets.com	open#ai#	其他-卖域名
openailawyers.com	openailawyers.com	open#ai#	其他-卖域名
www.chatgptforsupport.com	chatgptforsupport.com	chat#gpt#	其他-卖域名
www.chatgptwarehouse.com	chatgptwarehouse.com	chat#gpt#	其他-卖域名
chatbotaiconsulting.com	chatbotaiconsulting.com	hatbot#ai#	其他-卖域名
chat.aicontent.io	aicontent.io	ai#chat#	其他-卖域名
www.memechatgpt.com	memechatgpt.com	chat#gpt#	其他-卖域名
aihhugptdf.zlyy.com	zlyy.com	ai#gpt#	其他-卖域名
chatgptnft.pro	chatgptnft.pro	chat#gpt#	其他-卖域名
openai.git.com	git.com	open#ai#	其他-卖域名
openblockai.com	openblockai.com	open#ai#	其他-卖域名
www.chatgpttoldme.com	chatgpttoldme.com	chat#gpt#	其他-卖域名
getchatgptbusiness.com	getchatgptbusiness.com	chat#gpt#	其他-卖域名
chatgpt-forum.co	chatgpt-forum.co	chat#gpt#	其他-卖域名
www.chatgptforlaundry.com	chatgptforlaundry.com	chat#gpt#	其他-卖域名
openailegalcontent.com	openailegalcontent.com	open#ai#	其他-卖域名
aiwithgpt.com	aiwithgpt.com	ai#gpt#	其他-卖域名
www.chatgptsales.com	chatgptsales.com	chat#gpt#	其他-卖域名
aichanlove.chatroulettealternatives.com	chatroulettealternatives.com	ai#chat#	其他-卖域名
hostmaster.chaudeamy69.mypornchat.com	mypornchat.com	chat#chaude#	其他-卖域名
www.www.cahatopenai.com	cahatopenai.com	open#ai#	其他-卖域名
chatgptside.com	chatgptside.com	chat#gpt#	其他-卖域名
chatgptexchange.com	chatgptexchange.com	chat#gpt#	其他-卖域名
openaisex.com	openaisex.com	open#ai#	其他-卖域名
chatgptmycontent.com	chatgptmycontent.com	chat#gpt#	其他-卖域名
www.chatgptforeducation.org	chatgptforeducation.org	chat#gpt#	其他-卖域名
openaiexchange.com	openaiexchange.com	open#ai#	其他-卖域名
www.professor-chatgpt.com	professor-chatgpt.com	chat#gpt#	其他-卖域名
chatgptbusiness.us	chatgptbusiness.us	chat#gpt#	其他-卖域名
chatgptdominicanlawyer.com	chatgptdominicanlawyer.com	chat#gpt#	其他-卖域名
www.chatify-ai.com	chatify-ai.com	ai#chat#	其他-卖域名
www.chatgptworkouts.com	chatgptworkouts.com	chat#gpt#	其他-卖域名
openaimastermind.com	openaimastermind.com	open#ai#	其他-卖域名
aia50p.snapchatstock.com	snapchatstock.com	ai#chat#	其他-卖域名
www.vchatgpt.live	vchatgpt.live	chat#gpt#	其他-卖域名
chatgptagency.co.uk	chatgptagency.co.uk	chat#gpt#	其他-卖域名
www.epicchatgptprompts.com	epicchatgptprompts.com	chat#gpt#	其他-卖域名
www.openainow.com	openainow.com	open#ai#	其他-卖域名
www.chatgptsoftware.net	chatgptsoftware.net	chat#gpt#	其他-卖域名
www.arenaopenai.com	arenaopenai.com	open#ai#	其他-卖域名
shopifychatgpt.com	shopifychatgpt.com	chat#gpt#	其他-卖域名
www.chatgptai.digital	chatgptai.digital	ai#chat#gpt#	其他-卖域名
www.openaiportal.net	openaiportal.net	open#ai#	其他-卖域名
www-aiixfbgptn-com.nsoaven.com	nsoaven.com	ai#gpt#	其他-卖域名
www.u-chatgpt.net	u-chatgpt.net	chat#gpt#	其他-卖域名
www.chatboty-gpt.pl	chatboty-gpt.pl	chat#gpt#	其他-卖域名
www.chatgptadvice.net	chatgptadvice.net	chat#gpt#	其他-卖域名
www.easychatgpt.org	easychatgpt.org	chat#gpt#	其他-卖域名
chatgptdrlawyers.com	chatgptdrlawyers.com	chat#gpt#	其他-卖域名
thankschatgpt.com	thankschatgpt.com	chat#gpt#	其他-卖域名
chatgptvirtualhelp.com	chatgptvirtualhelp.com	chat#gpt#	其他-卖域名
www.sqlchatai.com	sqlchatai.com	ai#chat#	其他-卖域名
docker-ai-aliengpt-04.ccd.org	ccd.org	ai#gpt#	其他-卖域名
www.aitravelcopilot.com	aitravelcopilot.com	ai#copilot#	其他-卖域名
www.chatgpt.news	chatgpt.news	chat#gpt#	其他-卖域名
chatgpt-bot.online	chatgpt-bot.online	chat#gpt#	其他-卖域名
chatgptec.com	chatgptec.com	chat#gpt#	其他-卖域名
www.chatgptfloor.com	chatgptfloor.com	chat#gpt#	其他-卖域名
chatgptia.top	chatgptia.top	chat#gpt#	其他-卖域名
chatgptpartner.com	chatgptpartner.com	chat#gpt#	其他-卖域名
chatgpt5-zg.com	chatgpt5-zg.com	chat#gpt#	其他-卖域名
www.open-ai.gold	open-ai.gold	open#ai#	其他-卖域名
open.chat.ai.com.host	com.host	ai#chat#	其他-欺诈
ai-chatbot.so-app-digital.fr	so-app-digital.fr	hatbot#ai#	其他-其他语言
chatgptportable.com	chatgptportable.com	chat#gpt#	其他-其他语言
www.xn--d1ahagptsq.xn--p1ai	xn--p1ai	ai#gpt#	其他-其他语言
www.chazhuochatai.s-v.cn	s-v.cn	ai#chat#	其他-企业推广
gpt.chatgptstudy.cc	chatgptstudy.cc	chat#gpt#	其他-商城
chatgpt-ar14295.slack.com	slack.com	chat#gpt#	其他-社交chanel
openai.biz.id	openai.biz.id	open#ai#	其他-视频
0ai04-your-first-openstack.paypal-sicherererer.de	paypal-sicherererer.de	open#ai#	其他-数字货币
www.gov.ct3gb.realchatgpt.top	realchatgpt.top	chat#gpt#	其他-推广
zunyi.chatgpt258.com	chatgpt258.com	chat#gpt#	其他-网页暂停
www.smashchatgpt.com.magehelperblog.com	magehelperblog.com	chat#gpt#	其他-网站搭建
www.chatgptcontentsolutions.com	chatgptcontentsolutions.com	chat#gpt#	其他-网站更新
www.chatgptbillionaire.com	chatgptbillionaire.com	chat#gpt#	其他-网站在建
gpt4.chatcyx.top	chatcyx.top	chat#gpt#	其他-无明显意义
gpt3.aiyv123.top	aiyv123.top	ai#gpt#	其他-无明显意义
www.selfchatgpt.top	selfchatgpt.top	chat#gpt#	其他-无明显意义
chatai.202330.xyz	202330.xyz	ai#chat#	其他-无明显意义
lastchatgpt.z19.fun	z19.fun	chat#gpt#	其他-无明显意义
openai.jzfx.top	jzfx.top	open#ai#	其他-无明显意义
chatgpt.ylikli.com	ylikli.com	chat#gpt#	其他-无明显意义
mychatgpt.dougebf.top	dougebf.top	chat#gpt#	其他-无明显意义
shanghai-chat-gpt.online	shanghai-chat-gpt.online	chat#gpt#	其他-无明显意义
chatgpt.jtmi.me	jtmi.me	chat#gpt#	其他-无明显意义
chatgpt-web.apps.iytcloud.com	iytcloud.com	chat#gpt#	其他-无明显意义
www.ethicalopenai.org	ethicalopenai.org	open#ai#	其他-无明显意义
chatgptconsultancy.nl	chatgptconsultancy.nl	chat#gpt#	其他-无明显意义
jinsinangendiaochataichazhuo.kkkiii.com	kkkiii.com	ai#chat#	其他-销售
nd9gptah.xiaoaicha.com	xiaoaicha.com	ai#gpt#	其他-影院
webmail.sellchatgpt.com	sellchatgpt.com	chat#gpt#	其他-邮箱
aiopenapi.58.com	58.com	open#ai#	其他-众筹平台
chatgpt41819429.365mtk.com	365mtk.com	chat#gpt#	色情
java.gc.chat.aws.wms.caiwantai.top	caiwantai.top	ai#chat#	色情
gmpt3.shbicai.com	shbicai.com	ai#gmpt#	色情
chatgpt36127612.3dsharonfreed.com	3dsharonfreed.com	chat#gpt#	色情
chat.ai-hu.com	ai-hu.com	ai#chat#	色情
luju9panaw8gpa8aaig0pt5mqkce41ji.hw-ctg.top	hw-ctg.top	ai#g0pt#	色情
chat.promo.ai.www.bolangjiaoyu.top	bolangjiaoyu.top	ai#chat#	色情
gptai2ca.kk3002.top	kk3002.top	ai#gpt#	色情
chatgpt9971.bajiuge.com	bajiuge.com	chat#gpt#	色情
chatgpt42395.dcscrew.com	dcscrew.com	chat#gpt#	色情
www.guoneicepaishipinchaopengzaixiancesuozipai.housemae.com	housemae.com	open#ai#	色情
ailabs-chatbot.uqxtimr.com	uqxtimr.com	hatbot#ai#	色情
chatgpt83759.bu688.com	bu688.com	chat#gpt#	色情
chatgpt6554361.automan520.com	automan520.com	chat#gpt#	色情
zhsdgpt.ailika-by.com	ailika-by.com	ai#gpt#	色情
caobichaopengzipai.damzm.com	damzm.com	open#ai#	色情
chatgpt944881.cbsbakingshow.com	cbsbakingshow.com	chat#gpt#	色情
ailabs-chatbot.477o686h32.com	477o686h32.com	hatbot#ai#	色情
chatgpt47852992.ghwl-ahzx.com	ghwl-ahzx.com	chat#gpt#	色情
ai.helpchat.gis2.dkeyun.com	dkeyun.com	ai#chat#	色情
chat-gpt-nine-pi.vercel.app.host	app.host	chat#gpt#	停放
hxes.aigpt77.com	aigpt77.com	ai#gpt#	停放
sedah.cht-openai.com	cht-openai.com	open#ai#	停放
www.mcchatgpt.com	mcchatgpt.com	chat#gpt#	停放
www.openaimarketers.com	openaimarketers.com	open#ai#	停放
opensourcechat.com	opensourcechat.com	open#chat#	停放
mca.wwwchat-openai.com	wwwchat-openai.com	ai#chat#	停放
openainew.szdspps.com	szdspps.com	open#ai#	停放
chatgptdr.com	chatgptdr.com	chat#gpt#	停放
api-chatgpt.cn	api-chatgpt.cn	chat#gpt#	停放
www.open-ai.group	open-ai.group	open#ai#	停放
doingbusinesswithchatgpt.com	doingbusinesswithchatgpt.com	chat#gpt#	域名售卖
chatgpt89749.gvrands.com	gvrands.com	chat#gpt#	域名售卖
www.chatgpt5-ai.com	chatgpt5-ai.com	ai#chat#gpt#	域名售卖
